1101010101010111
0000000000000000
0000000000000000
1101010101010111
0000000000000000
0000000000000000
1101010101010111
0000000000000000
1110000000000000
0000000000000111
0000000000000000
1110000000000000
0000110000000111
0000000110000000
0000000000110000
0000000000000111
0000000000000000
0000000000000000
0000000000000000
0000000000000000