1111111111111111
1110000000000001
1110000000000001
0000100000000111
0000001000000000
1110000011000000
0000000000000111
0000000000000000
1110000000000000
0000000000000111
0000000000000000
1110000000000000
0000000000000111
0000000000000000
1110000011000000
0000001000000111
0000100000000000
1110000000000000
0000000000000000
0000000000000000