1101101101101111
0000000000000000
0000000000000000
1111011011011011
0000000000000000
0000000000000000
1101010101010111
0000000000000000
0000000000000000
1110000000000111
0000000000000000
0000000000000000
0000000000000111
0000000000000000
0000000000000000
0000111111111111
0000000000000000
0000000000000000
0000000000000000
0000000000000000