1010101010101011
0000000000000000
0000000000000000
1111111111111110
0000000000000000
0000000000000000
0111111111111111
0000000000000000
0000000000000000
1111111111111110
0000000000000000
0000000000000000
0111111111111111
0000000000000000
0000000000000000
1111111111111110
0111100000000000
0011000000000000
0000000000000000
0000000000000000