0000000110110111
0000000000000000
0000000000000000
1111111111110111
1000000000010000
1000000000010000
1010101000010111
0000000000000000
0000000000000000
0000000000000111
0010101000000000
0000000000000000
0000000100000111
0000000000000000
0000000010000000
0000001000000111
0000100000000000
0010000000000000
1000000000000000
0000000000000000